Lane,SampleID,Index,# Reads,# Perfect Index Reads,# One Mismatch Index Reads,# of >= Q30 Bases (PF),Mean Quality Score (PF)
1,PTC_ctTSO201216_HznMcRS5pc_L2001075,AGAGAACCTA-TAGCATAACC,228354192,223935792,4418400,40244235477,22.23
1,PTC_ctTSO201216_HznMcRS01pc_L2001076,GATATTGTGT-ACCGTGTGGT,228327100,223676411,4650689,40211126392,22.24
1,PTC_ctTSO201216_SrCMM1pc_L2001077,CGTACAGGAA-AGAGAACCTA,246793300,242924455,3868845,43434143702,22.22
1,PTC_ctTSO201216_SrCMM05pc_L2001078,CTGCGTTACC-TCGAGCCATA,237321274,233091182,4230092,41763664245,22.22
1,PRJ200620_L2001079,AGGCCGTGGA-AACGCACGAG,210094413,205882448,4211965,36693117996,22.14
1,PRJ200621_L2001080,AGGAGGTATC-TGCCAACTGG,189374536,186136731,3237805,33282676285,22.21
1,PRJ200622_L2001081,GCTGACGTTG-AATGCGAACA,214114379,210762378,3352001,37642611580,22.22
1,PRJ200623_L2001082,CTAATAACCG-CGATGCGGTT,199832082,195681365,4150717,35204287182,22.23
1,PRJ200624_L2001083,TCTAGGCGCG-TTAACCTTCG,238086827,234627817,3459010,41904103167,22.22
1,PRJ200625_L2001084,ATAGCCAAGA-CAGTGGCACT,254061011,249429739,4631272,44670609246,22.20
1,NTC_ctTSO201216KC_L2001085,TTCGGTGTGA-ATACTTGTTC,396881,388137,8744,59105407,20.19
1,Undetermined,Undetermined,106057092,106057092,0,16979124752,21.10
2,PTC_ctTSO201216_HznMcRS5pc_L2001075,AGAGAACCTA-TAGCATAACC,233039973,228703815,4336158,41196107525,22.27
2,PTC_ctTSO201216_HznMcRS01pc_L2001076,GATATTGTGT-ACCGTGTGGT,233886404,229292382,4594022,41292832936,22.26
2,PTC_ctTSO201216_SrCMM1pc_L2001077,CGTACAGGAA-AGAGAACCTA,252190813,248358100,3832713,44520766835,22.26
2,PTC_ctTSO201216_SrCMM05pc_L2001078,CTGCGTTACC-TCGAGCCATA,242961386,238753348,4208038,42883691551,22.25
2,PRJ200620_L2001079,AGGCCGTGGA-AACGCACGAG,214330599,210158845,4171754,37557078068,22.17
2,PRJ200621_L2001080,AGGAGGTATC-TGCCAACTGG,192859394,189654893,3204501,33999564889,22.24
2,PRJ200622_L2001081,GCTGACGTTG-AATGCGAACA,217443725,214158535,3285190,38321578994,22.25
2,PRJ200623_L2001082,CTAATAACCG-CGATGCGGTT,202776354,198731702,4044652,35823984821,22.26
2,PRJ200624_L2001083,TCTAGGCGCG-TTAACCTTCG,242645420,239214658,3430762,42827791685,22.25
2,PRJ200625_L2001084,ATAGCCAAGA-CAGTGGCACT,258888240,254271742,4616498,45661117320,22.24
2,NTC_ctTSO201216KC_L2001085,TTCGGTGTGA-ATACTTGTTC,420414,411294,9120,62922387,20.26
2,Undetermined,Undetermined,107701311,107701311,0,17464660791,21.24
